##########
#        #
###   P  #
#  X     #
#     O  #
##########